R 1500 1000

NO ./textures/wolf1.xpm
C 155,189 ,188
SO ./textures/wolf3.xpm

WE ./textures/wolf4.xpm

EA ./textures/wolf2.xpm
F 181,150,174
S ./textures/wolfsprite.xpm

111
111
111
        1111111111111111111111111
        1000000000112222222222221
        1011000001110020000000001
        1001000000000020000N00001
111111111011000001110020000000001
100000100011000001110111111111111
11110111111111011100000010001      
11110111111111011101010010001
11000001 10000011100000000001
10000001110000001100010010001
10000000000000000001010010001
11000001110101011101011110001
11110111 1110101 101111010001
11111111 1111111 111111111111
